9 17
|----------------|
|......|-P....--.|
|.F.|..|---....|.|
|..-|.@..........|
|......-...|.....|
|.--.......|...|.|
|....----.....-|.|
|......P|..F.|P..|
|----------------|